11111111111111111111111111111111
11111111111111111111111111111111
11111111111111111111111111111111
11111111111111111111111111111111
11111111111111111111111111111111
11111111111111111111111111111111
11111111111111111111111221111111
11111111111111111111112222111111
11111111111111111111112222111111
11111111111111111111112222111111
11111111111111111111112221111111
11111111111111121111112221111111
11111111111111111111112221111111
11111111111111111111112211111111
11111111111122211111111111111111
11111111111122211111111111111111
11111111111122211111111122222111
11111111111122211111222222222111
11111111111111111111222222222111
11111111111111111111222222221111
11111112211111111111222222211111
11111222221111111111111122111111
11112233321111111111111111111111
11112233332111111111111111111111
11112222332111111111111111111111
11111222222111111111111111111111
11111111221111111111111111111111
11111111111111111111111111111111
11111111111111111111111111111111
11111111111111111111111111111111
11111111111111111111111111111111
11111111111111111111111111111111
